Lady Firehair - леди Огневолосая
Jen'lig - Джен'лиг из Тотер-Ка из Ту'нарата
Midnight - Полночь
Pelligram - Пеллиграм
Qilandrha - Киландра
Divalir - Дивалир
Celestia - Целестия
Dynaheir - Динахейр
Khalindra - Халиндра
Shauhana - Шаухана
Drizzt - Дриззт До'Урден
Underdark - Андердарк
Sharkta Fai - Шаркта Фай
Githyanki - Гитиянки
Waterdeep - Вотердип
Irenicus - Айреникус
Alaundo - Алаундо
Haiass - Хайасс
Stormhorns - Штормовые Рога
Cloakwood - Клоаквуд
Elminster - Элминстер
Monteelah - Монтила
Quayle - Квэйл
Ghotal - Готал
Landrel - Ландрел
Yoshimo - Йошимо
Schael Corwin - Шаэль Корвин
Samuel - Самуэль
Symiaz - Симяз
Celestia - Селестия
Prime - Прайм, Первичный Материальный План
Szass Tam - Сзасс Там
Narghal Rasz - Наргал Раш
Ringhontal - Рингонтал
Sandra's magic parcel - Волшебная посылка
Qilue Veladorn - Куилью Веладорн
surfacer - наземник
Vennegrat - Веннеграт
Wallrick - Уоллрик
Dead Three - Трое Мёртвых
Клоаквуд
Кендлкип
Трёх Мёртвых, Трое Мёртвых
Побережье Меча
Eresseae Qilue - Эр'ссэа Килуи
dajemma - даджемма
